###############
# %   0      0#
#   #    0    #
#  A###   %   #
#            0#                
#   0 %#      #       
#     %# 0    #         
# ######      #
#  0# 0       #   
#   #%     %  #   
#   #         #
#    0   0%   #           
###############